Psychology

The Laws of Human Nature - Robert Greene - 1
Learned Optimism - Martin Selegman - 0
Influence - Robert Cialdini - 1
Evolutionary Psychology (5th Edition) - David Buss - 1
The H Factor of Personality - Kideom Lee & Michael Ashton - 0
Blink - Malcolm Gladwell - 0
Mans’ Search for Meaning - Viktor E. Frankl - 1
Thinking Fast and Slow - Daniel Kahneman - 0
How To Win Friends And Influence People - Dale Carnegie - 1
Riveted - Jim Davies - 0
Civilisation and Its Discontents - Sigmund Freud - 1
Psychology and You - Julia Berryman - 0
Curious - Ian Leslie - 0
Attached - Dr Amir Levine & Rachel Heller - 0
The Paradox of Choice - Barry Schwartz - 0
Emotional Intelligence - Daniel Goleman - 1
Pre_Suasion - Robert Cialdini - 0
Surrounded by idiots - Thomas Erikson - 0


Biography/Story

Unbroken - Laura Hillenbrand - 0
Made in America - Sam Walton - 1
The Autobiography of Andrew Carnegie - Andrew Carnegie - 0
Shoe Dog - Phil Knight - 0
Memories, Dreams & Reflections - Carl Jung - 1
Total Recall - Arnold Schwarzenegger - 0
Michael Jordan The Life - Roland Lazenby - 0
What You See Is What You Get - Alan Sugar - 0
Elon Musk - Ashlee Vance - 1
The Everything Store - Brad Stone - 1
Lord of The Flies - William Golding - 1






Health

Salt, Sugar, Fat - Michael Moss - 0
Gut - Giulia Enders - 0


Thinking / Mindset

Poor Charlie’s Almanack - Charlie Munger - 1
The 48 Laws of Power - Robert Greene - 1
Managing Oneself - Peter Drucker - 1
The Lessons of History - Will & Ariel Durant  - 1
PsychoCybernetics - Maxwell Maltz - 1
Mastery - Robert Greene - 1
Small Move, Big Change - Caroline Arnold - 0
A Few Lessons For Managers And Investors - Warren Buffett - 1
The Selfish Gene - Richard Dawkins - 0
Principles - Ray Dalio - 1
The Hypomanic Edge - John D. Gartner - 0
Grit - Angela Duckworth - 0
When - Daniel Pink - 0
The Art of Worldly Wisdom - Baltasar Gracian - 0
The Intelligent Investor - Benjamin Graham - 1 
Deep Work - Cal Newport - 0
The Law of Success - Napoleon Hill - 0
Bounce - Matthew Syed - 0
Relentless - Tim S. Grover - 0
Power vs Force - David R. Hawkins - 0
The Art of War - Sun Tzu - 1
The 33 Strategies of War - Robert Greene - 1
Thinking in Systems - Donella Meadows - 1
The Power of Habit - Charles Duhigg - 0


Philosophy

Meditations - Marcus Aurelius - 0
Discourses - Epictetus - 1
Letters from a Stoic - Seneca - 1
The Shortness of Life - Seneca - 1
Ego is The Enemy - Ryan Holiday - 0
The Obstacle is The Way - Ryan Holiday - 0
The Republic - Plato - 0
Eight Pillars of Prosperity - James Allen - 0

General Business

The innovators’ dilemma - Clayton Christensen - 0
Excel 2016 for Dummies - Greg Harvey - 0
Bookkeeping & Accounting for Dummies - Jane Kelly - 1
Zero to One - Peter Thiel - 0
Barbarians To Bureaucrats - Lawrence Miller - 0
The Lean Startup - Eric Ries - 0
Good To Great - Jim Collins - 0


Advertising

Ogilvy On Advertising - David Ogilvy - 1
Tested Advertising Methods - John Caples - 0
Contagious - Jonah Berger - 0
Scientific Advertising - Claude Hopkins - 1
How To Write A Good Advertisement - Victor Schwab - 0
